{
  "table": [
    [ "#", "#", "#", "#", "#", "#", "#", "#", "#", "#", "#", "#" ],
    [ "#", "X", " ", "X", "#", " ", " ", " ", " ", " ", " ", "#" ],
    [ "#", " ", " ", "#", "#", "C", "C", " ", "C", " ", " ", "#" ],
    [ "#", " ", " ", "X", "#", " ", " ", "#", " ", " ", " ", "#" ],
    [ "#", " ", " ", " ", " ", " ", " ", "#", "C", " ", "#", "#" ],
    [ "#", " ", " ", "X", "#", " ", " ", "#", "P", " ", "#", "#" ],
    [ "#", "#", "#", "#", "#", "#", "#", "#", "#", "#", "#", "#" ]
  ]
}