{
  "table": [
    [ "#", "#", "#", "#", "#", "#", "#", "#", "#", "#", "#" ],
    [ "#", " ", " ", " ", " ", " ", "#", " ", " ", "#", "#" ],
    [ "#", "X", "#", " ", " ", " ", " ", "C", " ", "#", "#" ],
    [ "#", " ", " ", " ", "X", " ", "#", " ", " ", "#", "#" ],
    [ "#", " ", " ", "#", " ", " ", "C", " ", " ", " ", "#" ],
    [ "#", " ", " ", "P", " ", " ", " ", "C", " ", " ", "#" ],
    [ "#", "#", "X", " ", "#", " ", " ", "#", " ", "#", "#" ],
    [ "#", "#", " ", " ", "#", "#", "#", "#", "C", " ", "#" ],
    [ "#", " ", " ", " ", " ", " ", " ", " ", " ", " ", "#" ],
    [ "#", "X", " ", " ", "#", "#", "#", " ", " ", "#", "#" ],
    [ "#", "#", "#", "#", "#", "#", "#", "#", "#", "#", "#" ]
  ]
}